Need to study:

The likelihood is that ...
The chances are that ...
To put it another way = In other words
in addtion to = aside from = apart from
It is conceivable that ... = It is imaginable that ...

mandatory subject = compulsory subject = required coursework
V+ing A over v+ing B, in my opinion, is preferable since ...
acquire proficiency in ... = become proficient in ...
A is superior to B
I would enjoy v+ing not only for sth, but also for sth.

handmade = hand-crafted
landing a job = finding a job
addressing issues = solving issues
compared to v+ing/sth = as opposed to v+ing/sth
excel in = be proficient in
squander = waste

In terms of A versus B, I prefer to A because ...
agricultural society = agrarian society
I thoroughly concur with this statement that ...
share secrets with others = confide in one another
eat out = dine out
It is reported that = Is it said that = According to estimates, 
sth/sb is on the cusp of sth, 

traveling alone = take on a solo trip
There is no truth in the statement that ... = The claim that ... is untrue.
look out for = take care of
not as good as sth = be inferior to sth
consider = take into account
be willing to = be inclined to
not catch up = fall behind
friends with common interests = like-minded firends
enroll sb in sth
a better method = a superior strategy
the best solution = the most appropriate solution = the most suitable solution
sometimes = occasionally

outdoor activity = outdoor pursuits
to a large extent = to a significant part
meaningless = pointless
enjoy the gorgeous scenes = take in the beautiful scenery
cause = result in






